width 17
height 17
layers 5

1	1	1	0	0	0	0	0	0	0	0	0	0	0	1	1	1
1	1	1	0	0	0	4	4	0	4	4	0	0	0	1	1	1
1	1	1	0	0	0	4	2	2	2	4	0	0	0	1	1	1
0	0	0	0	0	0	4	2	2	2	4	0	0	0	0	0	0
0	0	0	0	0	0	0	2	2	2	0	0	0	0	0	0	0
0	0	0	0	0	0	0	0	0	0	0	0	0	0	0	0	0
0	4	4	4	0	0	4	0	0	0	4	0	0	4	4	4	0
0	4	2	2	2	0	4	2	2	2	4	0	2	2	2	4	0
0	0	2	2	2	0	4	2	2	2	4	0	2	2	2	0	0
0	4	2	2	2	0	4	2	2	2	4	0	2	2	2	4	0
0	4	4	4	0	0	4	0	0	0	4	0	0	4	4	4	0
0	0	0	0	0	0	0	0	0	0	0	0	0	0	0	0	0
0	0	0	0	0	0	0	2	2	2	0	0	0	0	0	0	0
0	0	0	0	0	0	4	2	2	2	4	0	0	0	0	0	0
1	1	1	0	0	0	4	2	2	2	4	0	0	0	1	1	1
1	1	1	0	0	0	4	4	0	4	4	0	0	0	1	1	1
1	1	1	0	0	0	0	0	0	0	0	0	0	0	1	1	1



-1	-1	-1	27	-1	-1	-1	-1	-1	-1	-1	-1	-1	26	-1	-1	-1
-1	-1	-1	27	-1	-1	23	22	-1	23	22	-1	-1	26	-1	-1	-1
-1	-1	-1	27	-1	-1	15	-1	-1	-1	14	-1	-1	26	-1	-1	-1
25	25	25	31	-1	-1	21	-1	-1	-1	20	-1	-1	30	25	25	25
-1	-1	-1	-1	-1	-1	-1	-1	-1	-1	-1	-1	-1	-1	-1	-1	-1
-1	-1	-1	-1	-1	-1	-1	-1	-1	-1	-1	-1	-1	-1	-1	-1	-1
-1	23	13	22	-1	-1	22	-1	-1	-1	23	-1	-1	23	13	22	-1
-1	21	-1	-1	-1	-1	15	-1	-1	-1	14	-1	-1	-1	-1	20	-1
-1	-1	-1	-1	-1	-1	15	-1	-1	-1	14	-1	-1	-1	-1	-1	-1
-1	23	-1	-1	-1	-1	15	-1	-1	-1	14	-1	-1	-1	-1	22	-1
-1	21	12	20	-1	-1	20	-1	-1	-1	21	-1	-1	21	12	20	-1
-1	-1	-1	-1	-1	-1	-1	-1	-1	-1	-1	-1	-1	-1	-1	-1	-1
-1	-1	-1	-1	-1	-1	-1	-1	-1	-1	-1	-1	-1	-1	-1	-1	-1
24	24	24	29	-1	-1	23	-1	-1	-1	22	-1	-1	28	24	24	24
-1	-1	-1	27	-1	-1	15	-1	-1	-1	14	-1	-1	26	-1	-1	-1
-1	-1	-1	27	-1	-1	21	20	-1	21	20	-1	-1	26	-1	-1	-1
-1	-1	-1	27	-1	-1	-1	-1	-1	-1	-1	-1	-1	26	-1	-1	-1



-1	-1	-1	-1	-1	-1	-1	-1	-1	-1	-1	-1	-1	-1	-1	-1	-1
-1	-1	-1	-1	-1	-1	40	36	36	36	41	-1	-1	-1	-1	-1	-1
-1	-1	-1	-1	-1	-1	38	-1	-1	-1	39	-1	-1	-1	-1	-1	-1
-1	-1	-1	-1	-1	-1	38	-1	10	-1	39	-1	-1	-1	-1	-1	-1
-1	-1	-1	-1	-1	-1	38	-1	-1	-1	39	-1	-1	-1	-1	-1	-1
-1	-1	-1	-1	-1	-1	42	37	37	37	43	-1	-1	-1	-1	-1	-1
-1	40	36	36	36	41	15	36	36	36	14	40	36	36	36	41	-1
-1	38	-1	-1	-1	39	38	-1	-1	-1	39	38	-1	-1	-1	39	-1
-1	38	-1	10	-1	39	38	-1	10	-1	39	38	-1	10	-1	39	-1
-1	38	-1	-1	-1	39	38	-1	-1	-1	39	38	-1	-1	-1	39	-1
-1	42	37	37	37	43	15	37	37	37	14	42	37	37	37	43	-1
-1	-1	-1	-1	-1	-1	40	36	36	36	41	-1	-1	-1	-1	-1	-1
-1	-1	-1	-1	-1	-1	38	-1	-1	-1	39	-1	-1	-1	-1	-1	-1
-1	-1	-1	-1	-1	-1	38	-1	10	-1	39	-1	-1	-1	-1	-1	-1
-1	-1	-1	-1	-1	-1	38	-1	-1	-1	39	-1	-1	-1	-1	-1	-1
-1	-1	-1	-1	-1	-1	42	37	37	37	43	-1	-1	-1	-1	-1	-1
-1	-1	-1	-1	-1	-1	-1	-1	-1	-1	-1	-1	-1	-1	-1	-1	-1



11	11	11	11	11	11	11	11	11	11	11	11	11	11	11	11	11
11	11	11	11	11	11	11	11	11	11	11	11	11	11	11	11	11
11	11	11	11	11	11	11	11	11	11	11	11	11	11	11	11	11
11	11	11	11	11	11	11	11	11	11	11	11	11	11	11	11	11
11	11	11	11	11	11	11	11	11	11	11	11	11	11	11	11	11
11	11	11	11	11	11	11	11	11	11	11	11	11	11	11	11	11
11	11	11	11	11	11	11	11	11	11	11	11	11	11	11	11	11
11	11	11	11	11	11	11	11	11	11	11	11	11	11	11	11	11
11	11	11	11	11	11	11	11	11	11	11	11	11	11	11	11	11
11	11	11	11	11	11	11	11	11	11	11	11	11	11	11	11	11
11	11	11	11	11	11	11	11	11	11	11	11	11	11	11	11	11
11	11	11	11	11	11	11	11	11	11	11	11	11	11	11	11	11
11	11	11	11	11	11	11	11	11	11	11	11	11	11	11	11	11
11	11	11	11	11	11	11	11	11	11	11	11	11	11	11	11	11
11	11	11	11	11	11	11	11	11	11	11	11	11	11	11	11	11
11	11	11	11	11	11	11	11	11	11	11	11	11	11	11	11	11
11	11	11	11	11	11	11	11	11	11	11	11	11	11	11	11	11



0	0	0	0	0	0	0	0	0	0	0	0	0	0	0	0	0
0	0	0	0	0	0	1	1	0	1	1	0	0	0	0	0	0
0	0	0	0	0	0	1	0	0	0	1	0	0	0	0	0	0
0	0	0	0	0	0	1	0	2	0	1	0	0	0	0	0	0
0	0	0	0	0	0	0	0	0	0	0	0	0	0	0	0	0
0	0	0	0	0	0	0	0	0	0	0	0	0	0	0	0	0
0	1	1	1	0	0	1	0	0	0	1	0	0	1	1	1	0
0	1	0	0	0	0	1	0	0	0	1	0	0	0	0	1	0
0	0	0	2	0	0	1	0	2	0	1	0	0	2	0	0	0
0	1	0	0	0	0	1	0	0	0	1	0	0	0	0	1	0
0	1	1	1	0	0	1	0	0	0	1	0	0	1	1	1	0
0	0	0	0	0	0	0	0	0	0	0	0	0	0	0	0	0
0	0	0	0	0	0	0	0	0	0	0	0	0	0	0	0	0
0	0	0	0	0	0	1	0	2	0	1	0	0	0	0	0	0
0	0	0	0	0	0	1	0	0	0	1	0	0	0	0	0	0
0	0	0	0	0	0	1	1	0	1	1	0	0	0	0	0	0
0	0	0	0	0	0	0	0	0	0	0	0	0	0	0	0	0

